condition_ID,doc_0,doc_1,doc_2,doc_3,doc_4,doc_5,doc_6,doc_7,doc_8,doc_9,doc_10,doc_11,doc_12,doc_13,doc_14,doc_15,doc_16,doc_17,doc_18,doc_19,doc_20,doc_21
0,1,1,1,0,1,1,1,1,1,1,1,0,1,1,0,0,0,0,1,1,0,0
1,1,1,1,0,1,1,1,1,1,1,1,1,1,1,0,0,0,0,1,1,0,0
2,0,0,0,1,0,0,0,0,0,0,0,0,0,0,1,0,0,0,0,0,0,0
3,0,1,0,1,1,1,1,1,0,1,1,0,1,1,1,0,0,0,1,1,1,0
4,1,1,1,0,1,1,1,1,1,1,1,0,1,1,0,0,0,0,1,1,0,0
5,1,1,1,1,1,1,1,1,1,1,1,0,1,1,1,0,0,0,1,1,1,0
6,1,1,0,1,1,1,1,1,0,1,1,0,1,1,1,0,0,0,1,1,1,0
8,0,0,0,0,0,0,0,0,0,0,0,0,0,0,0,0,1,1,0,0,0,0
9,0,0,0,0,0,0,0,0,0,0,0,0,0,0,0,0,1,1,0,0,0,0
10,0,0,0,0,0,0,0,0,0,0,0,0,0,0,0,0,1,1,0,0,0,0
11,0,0,0,0,0,0,0,0,0,0,0,0,0,0,0,0,1,1,0,0,0,0
12,0,0,0,0,0,0,0,0,0,0,0,0,0,0,0,0,1,1,0,0,0,0
13,0,0,0,0,0,0,0,0,0,0,0,0,0,0,0,0,0,1,0,0,0,0
14,0,0,0,0,0,0,0,0,0,0,0,0,0,0,0,0,1,1,0,0,0,0
15,1,1,0,1,1,1,1,1,0,1,1,0,1,1,1,0,0,0,1,1,1,0
16,1,1,0,0,1,1,1,1,0,1,1,0,1,1,0,0,0,0,1,1,0,0
17,0,0,0,0,0,0,0,0,0,0,0,0,0,0,0,0,0,0,0,0,0,1
18,1,1,0,0,1,1,1,1,0,1,1,0,1,1,0,0,0,0,0,0,0,0
19,1,1,0,1,1,1,1,1,0,1,1,0,1,1,0,0,0,0,1,1,1,0
20,0,0,0,0,0,0,0,0,0,0,0,0,0,0,0,0,1,1,0,0,0,0
21,0,0,0,0,0,0,0,0,0,0,0,0,0,0,0,0,1,1,0,0,0,0
22,0,0,0,1,0,0,0,0,0,0,0,0,0,0,1,0,0,0,0,0,1,0
24,0,0,0,1,0,0,0,0,0,0,0,0,0,0,1,0,0,0,0,0,0,0
25,1,1,0,0,1,1,1,1,1,0,1,1,1,0,0,0,0,0,0,0,0,0
27,0,0,0,0,0,0,0,0,0,0,0,0,0,0,0,0,1,1,0,0,0,0
28,1,1,0,0,1,1,1,1,1,0,1,1,1,0,0,0,0,0,0,0,0,0
29,1,1,0,1,1,1,1,1,1,1,1,0,1,1,1,0,0,0,1,1,0,0
30,0,0,0,0,0,0,0,0,0,0,0,0,0,0,0,0,1,1,0,0,0,0
31,0,0,1,0,0,0,0,0,0,0,0,0,0,0,0,0,0,0,0,0,0,0
32,1,1,0,0,1,1,1,1,0,1,1,0,1,1,0,0,0,0,1,1,0,0
33,1,1,0,0,1,1,1,1,1,0,1,0,1,1,0,0,0,0,0,0,0,0
34,1,1,0,0,1,1,1,1,1,0,1,0,1,1,0,0,0,0,0,0,0,0
36,0,0,0,0,0,0,0,0,0,0,0,0,0,0,0,0,1,0,0,0,0,0
37,0,0,0,0,0,0,0,0,0,0,0,0,0,0,0,0,1,1,0,0,0,0
39,1,1,0,1,1,1,1,1,1,1,1,1,1,1,1,0,0,0,0,0,0,0
41,0,0,0,0,0,0,0,0,0,0,0,0,0,0,0,0,1,1,0,0,0,0
42,1,1,0,1,1,1,1,1,1,1,1,0,1,1,1,0,0,0,1,1,1,0
43,1,1,0,1,1,1,1,1,1,1,1,0,1,0,1,0,0,0,1,1,0,0
44,0,0,0,0,0,0,0,0,0,0,0,0,0,0,0,0,1,1,0,0,0,0
45,0,0,0,0,0,0,1,0,0,1,1,0,0,0,0,0,0,0,0,0,0,0
46,0,1,0,1,0,0,1,0,0,0,1,0,0,0,1,0,0,0,0,0,0,0
47,1,1,0,1,1,1,1,1,1,1,1,0,1,0,1,0,0,0,0,0,0,0
48,1,1,0,1,1,1,1,1,1,1,1,0,1,0,1,0,0,0,1,1,0,0
49,0,1,0,0,0,1,1,1,1,0,1,0,1,1,0,0,0,0,0,0,0,0
50,1,1,0,0,1,1,1,1,1,1,1,0,1,1,0,0,0,0,0,0,0,0
51,0,0,0,1,1,1,0,1,1,0,1,0,1,0,1,0,0,0,0,1,0,0
52,0,1,0,0,0,0,1,0,0,1,1,0,0,0,0,0,0,0,0,0,0,0
53,1,1,0,0,1,1,1,1,1,0,1,1,1,0,0,0,0,0,0,0,0,0
54,0,0,0,0,0,0,0,0,0,0,0,0,0,0,0,0,1,1,0,0,0,0
55,0,1,0,0,0,0,1,0,0,1,1,0,0,0,0,0,0,0,0,0,0,0
56,0,0,0,0,0,0,0,0,0,0,0,0,0,0,0,0,1,1,0,0,0,0
57,0,1,0,0,0,0,1,0,0,1,1,0,0,0,0,0,0,0,0,0,0,0
58,0,0,0,0,0,0,1,0,0,1,1,0,0,0,0,0,0,0,0,0,0,0
59,0,1,1,0,0,0,1,0,1,1,0,0,0,0,0,0,1,1,0,0,0,1
60,0,0,0,0,0,0,0,0,0,0,0,0,0,0,0,0,1,1,0,0,0,0
61,0,1,0,0,0,0,1,0,0,1,1,0,0,0,0,0,0,0,0,0,0,0
62,0,0,0,0,0,0,0,0,0,0,0,0,0,0,0,0,1,1,0,0,0,0
63,0,0,0,0,0,0,0,0,0,0,0,0,0,0,0,0,0,0,0,0,0,1
64,0,1,1,0,0,0,1,0,0,1,1,0,0,0,0,0,0,0,0,0,0,0
65,1,1,0,0,1,1,1,1,1,1,1,0,1,0,0,0,0,0,1,1,0,0
66,0,1,0,0,0,0,1,0,0,1,1,0,0,0,0,0,0,0,0,0,0,0
67,1,1,0,1,1,1,1,1,1,1,1,0,1,0,1,0,0,0,0,0,0,0
68,0,0,0,0,0,0,0,0,0,0,0,0,0,0,0,0,1,1,0,0,0,0
69,0,0,0,0,0,0,0,0,0,0,0,0,0,0,0,0,1,1,0,0,0,0
70,0,0,0,0,0,0,0,0,0,0,0,0,0,0,0,0,1,1,0,0,0,0
72,1,1,0,0,1,1,1,1,1,1,1,0,1,0,0,0,0,0,1,1,0,0
73,0,0,0,0,0,0,0,0,0,1,0,0,0,0,0,0,0,0,0,0,0,0
74,1,1,1,1,1,1,1,1,1,1,1,0,1,1,1,0,0,0,1,1,1,0
75,0,0,0,1,0,0,0,0,0,0,0,0,0,0,1,0,0,0,0,0,0,0
76,0,0,0,0,0,0,0,0,0,0,0,0,0,0,0,0,1,1,0,0,0,0
77,0,0,0,1,0,0,1,0,0,0,0,0,0,0,1,0,0,0,0,0,0,0
78,0,0,0,1,0,0,0,0,0,0,0,0,0,0,1,0,0,0,0,0,0,0
80,0,0,0,0,0,0,0,0,0,0,0,0,0,0,0,0,1,1,0,0,0,0
81,0,0,0,0,0,0,0,0,0,0,0,0,0,0,0,0,1,1,0,0,0,1
82,0,0,0,0,0,0,0,0,0,0,0,0,0,0,0,0,1,1,0,0,0,1
83,0,1,1,0,0,0,1,0,0,1,1,0,0,0,0,1,0,0,0,0,0,0
85,0,0,0,0,0,0,1,0,0,1,0,0,0,0,1,0,0,0,0,0,0,0
86,0,0,0,0,0,0,0,0,0,0,0,0,0,0,0,0,1,1,0,0,0,0
87,0,0,0,0,0,0,1,0,0,1,0,0,0,0,1,0,0,0,0,0,0,0
88,0,1,1,0,0,0,1,0,0,1,1,0,0,0,0,0,0,0,0,0,0,0
89,0,1,0,0,0,0,1,0,0,1,1,0,0,0,0,0,0,0,0,0,0,0
90,0,1,0,0,0,0,1,0,0,1,1,0,0,0,0,0,0,0,0,0,0,0
91,0,1,0,0,0,0,1,0,0,1,1,0,0,0,0,0,0,0,0,0,0,0
92,0,0,0,0,0,0,0,0,0,0,0,0,0,0,0,0,1,1,0,0,0,0
93,0,1,1,0,0,0,1,0,0,1,1,0,0,0,0,0,0,0,0,0,0,0
94,0,1,0,0,0,0,1,0,0,1,1,0,0,0,0,0,0,0,0,0,0,0
95,0,1,0,0,0,0,1,0,0,1,1,0,0,0,0,0,0,0,0,0,0,0
96,0,1,0,0,0,0,1,0,0,1,1,0,0,0,0,0,0,0,0,0,0,0
97,0,0,0,0,0,0,0,0,0,0,0,0,0,0,0,0,1,1,0,0,0,0
98,0,1,0,0,0,0,1,0,0,1,1,0,0,0,0,0,0,0,0,0,0,0
99,0,1,1,0,0,0,1,0,0,1,1,0,0,0,0,0,0,0,0,0,0,0
100,0,0,0,0,0,0,0,0,0,0,0,0,0,0,0,0,1,1,0,0,0,0
101,0,1,1,0,0,0,1,0,0,1,1,0,0,0,0,0,0,0,0,0,0,0
102,0,1,0,0,0,0,1,0,0,1,1,0,0,0,0,0,0,0,0,0,0,0
104,1,1,1,1,1,1,1,1,1,1,1,0,1,1,1,0,0,0,1,1,0,0